NO textures/text/north.xpm
SO textures/text/south.xpm
WE textures/text/west.xpm
EA textures/text/east.xpm

F 220,100,0
C 225,30,0

11111111
111111101
111     111
111     001
1111111111
10N0011
111111
