NO textures/text/north.xpm
SO textures/text/south.xpm
WE textures/text/west.xpm
EA textures/text/east.xpm

F 220,100,0
 225,30,0

111111111
111111111
111     111
111     111
11111111111
10N0011
111111
