NO 	./textures/north.xpm
SO  ./textures/south.xpm
WE ./textures/west.xpm
EA ./textures/east.xpm

F 220,100,0
C 225,30,0

111111111
111111111
111     111
111     111
11111111111
10N0011
111111
