NO textures/text/north.xpm
SO textures/text/south.xpm
WE textures/text/west.xpm
EA textures/text/east.xpm

F 220,100,0
C 225,30,0

                                                             
11111
1   1
11  111
10N01
11111
